XXXXXXXXXXXXXXXXXXXXXXXXX
X                       X
X XXXXX XXX XXXXXXXX XX X
X X     X X        X  X X
X X XXX X X XXXX X XXXX X
X X X X X X X  X X X  X X
X XXX X XXX X  X X XX X X
X     X   X XXXX X    X X
XXXXX XXX X      XXX XX X
X P   X X XXXXXX X X X  X
X XXX X X X    X X X XX X
X X X X X X XX X X X X  X
X X X XXX X XX X X X XXXX
X X X     X  X X X X X  X
X X XXXXXXX  X X X X X XX
X X        X X X X X X  X
X XXXX XXXXXX X XXX XXXX X
X           G           X
XXXXXXXXXXXXXXXXXXXXXXXXX